10 8
0000002000
0001000000
0000000000
0002000100
0000200000
0000001000
0100001000
0000020000