14 8
00000020000000
00010001000200
00000000000000
00020001000000
00002000001000
00000010010000
00100010000000
00000200000200